77,5999999999995
920
10
14
2
1,2
1
3 3 3 1 1 3 3 3 3 3 1 3 3 3 1 3 3 3 1 3 3 3 3 3 1 1 3 3 3 3 1 3 1 3 1 3 3 1 3 3 3 1 1 0 1 3 3 3 
1 1 3 1 1 3 1 1 1 3 3 3 1 3 3 1 1 3 3 3 1 1 1 1 3 3 3 1 1 3 1 1 3 3 1 3 1 1 3 1 3 1 3 1 3 3 1 3 
3 3 0 1 3 3 1 3 3 1 1 3 1 3 3 3 3 3 3 3 1 3 3 3 3 1 3 1 3 3 3 3 3 1 3 3 3 3 3 1 3 3 1 3 3 1 1 3 
3 1 3 1 1 3 3 3 3 3 1 3 3 3 1 3 3 1 1 3 3 1 3 3 1 3 3 1 3 1 1 3 1 3 3 1 1 1 1 3 1 3 1 3 1 1 1 3 
3 1 3 3 3 1 1 1 1 3 1 3 1 1 3 1 3 3 1 3 3 3 3 1 3 3 1 1 3 3 1 3 3 3 1 1 3 3 3 3 1 3 1 3 3 3 3 3 
3 3 1 3 3 3 3 3 1 3 1 3 3 3 1 1 3 3 1 3 1 1 1 3 3 1 1 1 1 3 3 3 3 1 3 3 3 1 1 1 3 3 3 3 3 1 4 1 
1 3 3 1 1 1 1 3 3 3 1 1 1 3 3 1 3 1 3 3 3 1 3 3 1 3 1 3 1 3 1 1 4 1 1 1 3 1 1 3 3 1 1 3 3 1 3 3 
1 1 3 3 1 3 3 3 3 1 3 1 3 1 3 1 3 1 3 1 1 3 3 1 3 3 3 1 1 4 3 1 3 3 3 3 3 1 3 3 1 3 1 3 1 3 1 3 
3 3 1 3 3 3 3 1 3 1 3 3 3 1 3 3 3 1 3 1 3 3 1 3 3 1 3 3 3 1 3 3 1 1 3 3 1 3 3 1 1 3 3 3 1 3 3 3 
1 1 1 1 1 1 3 1 3 3 1 3 1 1 3 1 1 3 3 3 3 1 3 3 1 1 1 1 3 3 1 3 3 1 1 1 3 3 1 3 1 3 1 3 1 1 1 1 
3 3 3 3 3 3 1 3 3 3 1 3 1 3 3 3 1 3 1 3 1 3 3 1 1 1 3 1 3 3 3 1 3 3 3 3 3 1 1 3 1 3 3 3 3 3 3 3 
3 3 1 1 1 3 1 3 1 1 1 3 3 3 1 3 1 3 3 3 1 3 1 3 3 3 3 1 3 1 3 3 1 1 1 3 3 3 3 3 1 3 3 1 3 1 1 3 
1 3 1 1 1 3 1 3 3 3 3 3 1 1 3 3 1 3 1 3 1 3 3 3 1 1 1 1 3 3 1 4 3 3 1 3 1 3 1 3 3 1 3 3 1 3 3 3 
3 3 3 3 1 3 3 3 1 1 1 1 3 3 3 1 3 3 3 3 1 4 1 3 3 3 3 1 1 3 1 3 1 3 3 3 1 3 1 1 3 1 1 3 3 3 1 1 
3 1 1 3 1 3 1 3 3 3 1 1 1 1 1 1 3 1 1 3 1 1 1 3 3 1 3 3 3 3 3 3 3 1 1 1 1 3 3 3 3 1 3 3 1 3 3 3 
3 3 1 3 3 1 3 3 1 3 3 3 3 1 1 3 3 1 1 3 3 3 3 3 1 1 3 1 3 1 1 1 3 1 3 3 3 1 3 1 3 1 3 3 1 1 1 3 
1 3 3 1 3 3 3 1 1 3 3 1 3 3 3 3 1 1 1 3 1 3 1 1 3 3 3 1 3 3 3 1 3 1 3 1 3 3 3 1 3 3 1 3 1 3 3 3 
3 1 1 3 3 3 3 1 3 3 1 1 3 3 1 1 1 3 3 3 4 3 5 1 3 3 1 3 1 1 3 1 3 1 3 3 1 3 1 1 1 3 3 3 1 3 1 1 
3 1 1 3 1 1 1 3 3 1 1 3 3 1 1 3 3 3 1 1 3 3 3 4 1 3 1 3 1 3 3 3 1 1 1 3 3 3 3 3 3 1 1 1 3 3 3 3 
3 1 3 3 3 3 1 1 3 3 3 3 1 3 3 3 1 3 1 1 1 1 1 3 1 3 3 1 3 3 1 3 3 3 1 3 1 1 3 1 3 3 3 1 3 1 1 3 
1 4 3 1 1 3 3 1 3 1 3 1 3 3 1 3 1 3 3 3 1 3 3 3 3 3 3 1 3 1 3 1 1 3 3 3 3 1 3 1 3 1 3 3 1 1 3 3 
3 3 1 3 1 1 3 3 3 1 3 3 3 1 1 3 3 3 1 3 4 3 1 1 1 1 1 1 3 3 3 1 4 1 3 1 3 1 3 3 3 1 1 3 3 3 3 1 
