18,1
3
0
0
0
323232333232333332323233333232333332323232323233333232323232333232323233323233333332323233323232
323332333332323232333233333232323232333333333232323233333332323233333232333332323232333332323332
323332323332323333333232333233333233323232323333333332323233333332323332323232333332323233333232
323233323233323332323332333232333232323333323333333333333333323232333233333232323233333232323233
333233333232333332323232333332323233333232323232323232323233323332333333333233333232323333323232
323233323332323332333232323232333233323232333232333233323233323332323232323232323333323232323332
323332323233323232333233333332323232323332323333323233323233323332333232333333323233323333333332
323233333333333333323232323233333332333333323232323233333233333232333233333332333233323333323232
333232323232323333323333333232323332323232333332333232323232323233323232323233323233333232323333
333233323233323332323233323233323233333333333232333333323333323232333333323233323332323233323232
323233333332323332333332323332323232323232323233333332323232323332333233323232323232323332333332
323332323233333332323232323333323333323233333233323232333333323332333232333333333233323333333232
323332333232323233333233323332323332323332323232323333323333333232323332323232323232323232323233
323332333332333232323332323332323332333332333333333232333232323233323233323333333333333332323332
323232323332333333333232333333323332333232323232323332323233323332333233323333323232323333323332
333233323332323232323233323232323332323333333333323232323332323333323233323232323333323232323332
323232333333323333323233333232333233323332323232323333323332323333323233333333333232333232333232
323333323232323232323232323232333233323232333333333232323333333333333232333232323233333233323233
323232323333333233333332333332323333323233323232323233323232323232323232333233323332333232323332
333232323232323232323232333233323233323233323333323333323332323332333232333233323233323332333232
333233333232333332333332333232333232333333323232333232323333333332323232323232333232333232333232
323233323332323232333232333232323332323232323332323233323232323332323333333332323332323233323232
