16,8999999999998
3
200
323332323333323332323233323232323333333332323332323232323232323232323233323233333333323332333232
323232323235333232333233323333323532323232333332333333333333333333333233323232323232333232323233
333233333332323233323233323232333232323332333332323233333333323233323233333332333332323233333232
333232323232323233323232333332323233333332323233333332323232323332323332333332333332333333333233
323233333233333333333332333332333332323233323332323232333333323332333233323232323332323232323232
323332323333323232333232333232323333333233323232333232323233323232333232323333323233323333323332
323233323332323332323233333233323232323233323333323233333232323332323232323332333333323233323333
333232323332333233333232333233333332333333323233323332323335323333333333323233323232333233323232
333532323332333232333232323332323332323232333232323332333332333532323333333232323332333232323332
323533323332323332333333323232353233333332333333333232333232333233323232333333333232323333323332
333332323333323232333232333333333232323332323233333233323233323233323332323233323233323233323332
323232333332323233333232323232333333323232333232323233323332323333323233323233323332333232323332
323332323232333232323233333332323232333332323333333332323333323332323332323333323233323233333332
323233333333333233333332333332323332323333323233323232333232323332333332323332333233323333323232
333232333232333232323332323333323333333232333233323333333232323232333233323333323233323232323333
323332323333333333323233323233323232323233323233323233323233333232333233323232323232333232333332
323233323332323233333333323232323332333233323232323233323332353332323332333335333332323332333232
323332323232333232323233323233323232333233323333333333323232333233323233323232323233323232323233
323332333333333332333232333232333332323233323333333232323333333232333332323333333333333333333233
333332323232323232333233323332333333333333323232323233323232323332323232333232323232323232323233
323232333232323233323233323332323232323232323232333333333332323332333333333233333232333333333232
323333323333333232323332323233323233323233333333323232323232333332323232323233323233323232323332
